..^######..........................
........#..........................
........#..........................
........#..........................
........#..........................
........#..........................
#########..........................
#..................................
#..................................
#..................................
#..................................
#..................................
#..................................
#..................................
#..................................
#..................................
#####..............................
....#..............................
....#..............................
....#..............................
....#..............................
....#..............................
....###########....................
..............#....................
..............#...........#########
..............#...........#........
..............#...........#........
..............#...........#........
..............#...........#........
..............#...........#........
........#######...........#........
........#.................#........
........#.................#........
........#.................#........
#######.#...........#######........
#.....#.#...........#..............
#.....#.#...........#..............
#.....#.#...........#..............
#.....#.#...#####...#..............
#.....#.#...#...#...#..............
#########...#...#...#..............
......#.....#...#...#..............
......###########...#..............
............#.......#..............
....#####...#.#######..............
....#...#...#.#....................
....#...#...#.#....................
....#...#...#.#....................
....#############..................
........#...#.#.#..................
......#######.#.#..................
......#.#.....#.#..................
......#.#.###########..............
......#.#.#...#.#...#..............
#########.#...#.###########........
#.....#...#...#.....#.....#........
#.....#...#####.....#.....#........
#.....#.............#.....#........
#.....#.............#.....#........
#.....#.............#.....#........
#######.............#######........

